111111111
100000001
1000E0001
100000001
10C000001
100000P01
111111111