11111111111111111
1CPE1000000000001
1101100C000000C01
1000000000C000001
10000000M0C000001
100M000000C000001
11111111111111111